44 ############################################
#@@@@@@@@@@@@@@@@@@@@@@@@@@@@@@@@@@@@@@@@@@@
#@@@@@@@@@@@@@@@@@@@@@@@@@@@@@@@@@@@@@@@@@@@
#@@@@@@@@@@@@@@@@@@@@@@@@@@@######@@@@@@@@@@
#@@@@@@@@@@@@@@@@@@@@@@#####@@@@@@###@@@@@@@
#@@@@@@@@@@@@@###@@@##@@@@@@@@@@@@@@@#@@@@@@
#@@@@@@@@####@@@#@@@@@@@@@@@@@@@@@@@@@#@@@@@
#@@@@####@@@@#@@#@@@@@@@@@@@@@@@@@@@@@@#@@@@
#0@@@@@@@@@@@@@@#@@@@@@@@@@@@@@@@@@@@@@@#@@@
############################################