173 #############################################################################################################################################################################
########@@@@@@@@@@@@@R@@@@@@@##@@@@##########@@@@@@@########@@@@@@@@@@@@@@HHH@@@@@@@@@@@###@@@@@@@@@@@@@@@D@@@@@@@@R@@@@@@@@@@@O@@@@@@@@@@@@@@@@@@@@@@@@@@@@@@@@@@@@@@@@@@@##
######@@@@@@@@@@|##########@@@@@@@@@######H##@@@@@@@@@@@@@@@@@@@@@@@@|#-#####@@@@@@@@@@###@@@@@@@@@@@@|###################################@@@@@@@@@@@@@@@#|###############-##
####@@@@@@@@@@@@|@@@@@@@@@@@@@@@@@@@@##O@@@@@@@@@@@@@@@@@@@@@@@@@@@@@|@#@@@@@@@@@@@@#####@@@@@@@@@@@@@|@@@@@@@@@@@@@@@@@@@@@@@@@@######@@@-#-#-#######-##@|@@@@@@@@@@@@@##@@#
####@@@@@@@@@@@@|@@@@@@@@@@-###-##@@@@@#####|###|###############-####|@@@@@@ORD#######@@@@@@@@@@@@@########@@@@@D@@@H@@@@@@@@@##@@@######@@@@@@@@@O@@@@@D@@@@@@@@@@@@@@@@@#@#
####@@@@@@@@@@@#|###-###@@@@@@@@@H#@@@@@@###|##H|@@D@@@@######@@@@@##|@@@O######@@@@@@@@@@#####|######################H@H@@@@#####@@@@###XRDORDORDHRODROHRDO@@@@@HH@@H@@H@@H#
###@@@@@@@@@@@##|##@@@##@@@@@@@@#####@@@@@@#|###############@@@HHH@@@######@@@@@@@@@@######@@@@|@@@@@@@@@@@@@@@@@@@@@@####@@@@@##@@@@@@@###################################|#
##@@@@@@@@@#####|@@@@@H@@@@@@@@@@@@O#@@@@@@@|@@@@@@@@@@@@#@@@@@###@@@@@@@@@@@@@@@@@#####HHH@@@@|@@@@@@@@@@@@RDORDOHH@@@@####@@@@@@@@@@@@@@####@@@@@@@@@@@@@@@@@@@@@@@@@@@@@|#
#H@@@@@#########@###@###@@@@@@@@@@RH##@#@@@@RD@@@H@@@@@@O#---#@@@@@@@@@@@R@@@@@D@@#################@###################HH@@@@@@@@R@@@@@@D@@O####@@@@@@@@@@@HHHHHHH@@@@HHHHH|#
################S###S#################S###################SSS######################################S#########################################################################